4 0 2 0 0 2 0 4
0 2 2 0 0 2 2 0
2 2 4 0 0 4 2 2
2 2 0 0 0 0 2 2
2 2 0 1 1 0 2 2
2 2 1 3 3 1 2 2
0 2 2 0 0 2 2 0
0 0 2 2 2 2 0 0
2 2 0 0 0 0 2 2
4 2 0 0 0 0 2 4


